NO ./textures/mossy.xpm
SO textures/south_texture.jpg
EA textures/east_texture.jpg
WE textures/west_texture.jpg

C 233,0,8
F 0,0,255

1111111111111111111111111111111111
1000010000111111111111111100000001
1000010000111111111111111100000001
1000011001100000000000000000000001
1000000000000000000000000000000001
1000000000000000000000000000000001
1000000000000000000000000000000001
1000000111110000000000000000000001
100000011111000000000000000000W001
1000000111110000000000000110000001
1000000000000000000000000110000001
1111111111111111111111111111111111