NO
SO
EA
WE

C
F

11111111111              111111111
10000100001              100000001
1000010000111111111111111100000001
1000011001100000000000000000000001
1000000000000000000000000000000001
1000000000000000000000000000000001
1000000000000000000000000000000001
1000000111110000000000000000000001
10000001111100000000000N0000000001
1000000111110000000000000110000001
1000000000000000000000000110000001
1111111111111111111111111111111111