NO textures/north_texture.jpg
SO textures/south_texture.jpg
EA textures/east_texture.jpg
WE textures/west_texture.jpg

C 255,30,0
F 0,0,255

11111111111              111111111
10000100001              100000001
1000010000111111111111111100000001
1000011001100000000000000000000000
1000000000000000000000000000000001
1000000000000000000000000000000001
1000000000000000000000000000000001
1000000111110000000000000000000001
10000001111100000000000N0000000001
1000000111110000000000000110000001
1000000000000000000000000110000001
1111111111111111111111111111111111